Nol – khong 
Satu - it
Dua - ji
Tiga - sa
Empat - si
Lima – goh
Enam - lak
Tujuh - jhit
Delapan - pek
embilan - khau
Sepuluh - cap
Sebelas – cap it
Dua belas – cap ji
Tiga belas – cap sa
tujuh belas – cap jhit
Dua puluh Satu – ji cap it
Dua puluh dua – ji cap ji
Tiga puluh delapan – sa cap pek
Empat puluh tiga – si cap sa
Lima puluh – goh cap
Seratus – ce pak
Seratus satu – ce pak khong it
Seratus sepuluh – ce pak cap
Seratus empat belas  - ce pak cap si
Seratus lima puluh tiga – ce pak goh cap sa
apel - pheng ko 
jeruk – kam
jeruk nipis - seng kam
pisang - kin cio
pir - laiya
semangka - si kua
pepaya - bok kua / mok kua 
nenas - ong lai
kelapa – ia
belimbing – belimbing atau anggur – phu to
kucing – ngiao
kelinci  - pek tho
anjing - kau
ayam - ke
ikan - hu
bebek – akk
sapi - gu
gajah - chio
monyet – lao kau
burung - chiaw
Warna Putih – pek sek
Warna Hitam - o Sek
warna Merah – ang sek
Warna Biru - Lam Sek
Warna Merah Jambu - Cui Ang Sek
Warna Kuning - Ui Sek / uwi sek
Warna Hijau - Che Sek
Warna Ungu - Kio Sek
Warna Emas - Kim Sek 
Warna Perak - Gin Sek